#################
#S    #     #   #
# ### # ### # # #
# #     #   # # #
# # ### ### ### #
#   #     #     #
### ### ### ### #
#     #         #
# ### ### ### # #
#   #     #   #E#
#################
