################
#S       #     #
#  ### #   ##  #
#      #  ###  #
# ## #### #    #
#      #   #####
# ### ## ###   #
# #          # #
# ### ###### # #
#     #       E#
################